
selpa'i = se prami
norsmu = no'e smuni
gunspoja = gunka spoja
menkei = menli kelci
terdatni = te datni
jbopre = lojbo prenu
jbobau = lojbo bangu
cabdei = cabna djedi
gendra = gerna drani
plixau = pilno xamgu
sampla = skami platu
tanbla = tsani blanu
selbri = se bridi
djisku = djica cusku
jbovlaste = lojbo valsi liste
glibau = glico bangu
blutolpinxe = ciblu to'e pinxe
skudji = cusku djica
terpreti = te preti
pampe'o = prami pendo
selsku = se cusku
fu'ivla = fukpi valsi
kribacru = krici bacru
samselpla = skami se platu
bavlamdei = balvi lamji djedi
nintadni = cnino tadni
xagmau = xamgu zmadu
jungau = djuno gasnu
cmevla = cmene valsi
vlaski = valsi skicu
zmanei = zmadu nelci
malgli = mabla glico
tcetce = mutce mutce
mrobi'o = morsi binxo
xrukla = xruti klama
prulamdei = purci lamji djedi
tinju'i = tirna jundi
selkei = se kelci
titnanba = titla nanba
brivla = bridi valsi
lemnau = le'e nanmu
malglico = mabla glico
jbofi'e = lojbo finpe
balcu'e = banli ckule
jbocre = lojbo certu
ninpre = cnino prenu
tolzdi = to'e zdile
jbonunsla = lojbo nu salci
tolmorji = to'e morji
jbota'a = lojbo tavla
jbosnu = lojbo casnu
tolmo'i = to'e morji
xamsku = xajmi cusku
cavlu'i = carvi lumci
zanfri = zabna lifri
vlasisku = valsi sisku
sofybakni = softo bakni
mencre = menli certu
cinsne = cinse senva
smudra = smuni drani
selbeimanti = se bevri manti
selma'o = se cmavo
tolcando = to'e cando
vlaste = valsi liste
mriste = mrilu liste
se'ixru = sevzi xruti
nalvai = na'e vajni
noltru = nobli turni
selcme = se cmene
rapcreze'a = rapli certu zenba
ci'erkei = ciste kelci
zirbolci = zirpu bolci
terve'u = te vecnu
tolci'o = to'e citno
samru'e = skami pruce
dormijysai = donri midju sanmi
xalbebna = xalka bebna
ckakla = ckana klama
fa'orma'o = fanmo cmavo
mencti = menli citka
zi'evla = zifre valsi
crezenzu'e = certu zenba zukte
nerkla = nenri klama
lobypli = lojbo pilno
samymri = skami mrilu
sorprekarce = so'i prenu karce
relsnanu = re snanu
jbogu'e = lojbo gugde
termu'eske = te munje saske
varkiclaflo = vacri kicne laflo
velsku = ve cusku
mletca = melbi tcadu
samtci = skami tutci
lojbau = logji bangu
nolraitru = nobli traji turni
prulamcte = purci lamji nicte
cnima'o = cinmo cmavo
cmocrida = cmoni crida
runbau = rutni bangu
tolcliva = to'e cliva
jbocme = lojbo cmene
citmle = citno melbi
nalgundei = na'e gunka djedi
mergu'e = merko gugde
zdaspoja = zdani spoja
tolmencre = to'e menli certu
zerle'a = zekri lebna
dragau = drani gasnu
pitnanba = plita nanba
kinzga = skina zgana
zdakemkulgu'a = zdani ke ckule gunka
selsa'a = se sanga
nelrai = nelci traji
selsau = se slabu
sumtcita = sumti tcita
cersai = cerni sanmi
tolcanci = to'e canci
retsku = preti cusku
fonta'a = fonxa tavla
xagrai = xamgu traji
selsnu = se casnu
xumske = xukmi saske
batkyci'a = batke ciska
nunctu = nu ctuca
jbovla = lojbo valsi
blupinxe = ciblu pinxe
nonkansa = no kansa
peisku = pensi cusku
selsanga = se sanga
relxilma'e = re xislu marce
jvajvo = javni lujvo
mafyxli = makfa nixli
mumdei = mu djedi
xunplini = xunre plini
ponbau = ponjo bangu
purlamdei = purci lamji djedi
cinmle = cinse melbi
noltruni'u = nobli turni ninmu
selsmu = se smuni
zdicaudri = zdile claxu badri
gimste = gismu liste
simple = simxu pelji
toljundi = to'e jundi
selprami = se prami
pamjai = prami jgari
sanbau = spano bangu
zgipli = zgike pilno
jbominji = lojbo minji
nunkei = nu kelci
ctufau = ctuca fasnu
jacke'o = djacu kelvo
kajypla = kanji platu
dracyselkei = draci se kelci
jboju'i = lojbo jundi
jboselkei = lojbo se kelci
mlemencrekei = melbi menli certu kelci
selmri = se mrilu
terbri = te bridi
zilkancu = zi'o kancu
jbope'o = lojbo pendo
jbopli = lojbo pilno
neizma = nelci zmadu
tolmle = to'e melbi
jvofi'i = lujvo finti
purlamcte = purci lamji nicte
najnimre = narju nimre
nunji'e = nu jmive
pavyseljirna = pa se jirna
ninjbo = cnino lojbo
selcmi = se cmima
selpli = se pilno
pavdei = pa djedi
fircku = flira cukta
mulgau = mulno gasnu
cabycte = cabna nicte
mojgau = morji gasnu
tolcertu = to'e certu
xauzma = xamgu zmadu
jbedetnunsla = jbena detri nu salci
temtru = temci turni
vlatai = valsi tarmi
noltrunau = nobli turni nanmu
zeldei = ze djedi
cfagau = cfari gasnu
rarbau = rarna bangu
selkai = se ckaji
labnytru = labno turni
mlismu = milxe smuni
selci'a = se ciska
cmaxi'a = cmalu xirma
pijyske = prije saske
selpu'a = se pluka
spusku = spuda cusku
zu'edji = zukte djica
fekcrida = fenki crida
nunsnu = nu casnu
seldji = se djica
tcenei = mutce nelci
jaupre = djacu prenu
nalnei = na'e nelci
bregau = bredi gasnu
genrei = gerna preti
kargau = kalri gasnu
toldarsi = to'e darsi
cakyrespa = calku respa
dontu'u = do tubnu
cimjvo = cilmo lujvo
lercu'aca'a = lerfu cuxna cabra
seltcana = se tcana
tercme = te cmene
tolcri = to'e cirko
xavdei = xa djedi
sursipna = surla sipna
baupli = bangu pilno
jbocifnu = lojbo cifnu
nabypalne = nanba palne
snuju'i = casnu jundi
tolcitno = to'e citno
mulkla = mulno klama
nuncasnu = nu casnu
selnei = se nelci
xarpre = xanri prenu
zdakla = zdani klama
cizda'u = cizra danlu
ckupau = cukta pagbu
muvgau = muvdu gasnu
nalju'i = na'e jundi
ricfoi = tricu foldi
selsampla = se skami platu
vlacku = valsi cukta
datnyvei = datni vreji
jibgu'a = jibri gunka
snaveitci = sance vreji tutci
crexalbo = certu xalbo
xalxalbo = xalka xalbo
jboba'usnu = lojbo bacru casnu
nunjmive = nu jmive
samci'ejudri = skami ciste judri
caucni = claxu cinmo
genturfa'i = gerna stura facki
jboski = lojbo skicu
klamu'o = klama mulno
tolcafne = to'e cafne
malgletu = mabla gletu
xumjimcelxa'i = xukmi jinme cecla xarci
nalgendra = na'e gerna drani
zdazva = zdani zvati
xamselsku = xajmi se cusku
samselkei = skami se kelci
zilkai = zi'o ckaji
brogu'e = xebro gugde
cmibi'o = cmima binxo
pincyvi'i = pinca vikmi
vladra = valsi drani
baldunra = banli dunra
cadycta = cando catlu
fetspe = fetsi speni
gligu'e = glico gugde
jbojbo = lojbo lojbo
jugbau = jungo bangu
mapypre = mapku prenu
ctefa'o = nicte fanmo
nondei = no djedi
rejgau = vreji gasnu
seltcidu = se tcidu
snavei = sance vreji
zanmla = zabna mlana
cnivla = cinmo valsi
kibypapri = kibro papri
tersmu = te smuni
torcrida = tordu crida
crebi'o = certu binxo
jbocevni = lojbo cevni
nunsla = nu salci
sispe'i = sisku penmi
zunsna = zunti sance
baupla = bangu platu
cpicinfo = cipni cinfo
jbocei = lojbo cevni
tolcre = to'e certu
celgunta = cecla gunta
cipcta = cipra catlu
complete = co'e plete
jbixa'u = jibni xabju
naljbo = na'e lojbo
selbeiskami = se bevri skami
sezyxru = sevzi xruti
spogau = daspo gasnu
tersla = te salci
tolju'i = to'e jundi
velcli = ve cilre
snujundi = casnu jundi
tolrinsa = to'e rinsa
bebzunpre = bebna zunti prenu
dormijnunsla = donri midju nu salci
prula'i = purci lamji
xamgau = xajmi gasnu
damva'u = danmo vasxu
nakpinji = nakni pinji
tamgau = tarmi gasnu
toldra = to'e drani
tolmelbi = to'e melbi
vondei = vo djedi
jvoprami = lujvo prami
kadnygu'e = kadno gugde
kamjunmre = ka djuno merli
naljundi = na'e jundi
reisku = preti cusku
selcusku = se cusku
sezysku = sevzi cusku
vimku'a = vikmi kumfa
ma'oste = cmavo liste
narju'o = na djuno
nunpenmi = nu penmi
samyzva = skami zvati
kafybarja = ckafi barja
pamli'u = prami litru
seltau = se tanru
sezgle = sevzi gletu
sipydji = sipna djica
tolcinri = to'e cinri
brobau = xebro bangu
jboklu = lojbo kulnu
reldei = re djedi
samske = skami saske
selbau = se bangu
selsne = se senva
tertau = te tanru
xisyjbenunsla = xriso jbena nu salci
jbosku = lojbo cusku
judrysni = judri sinxa
matpai = mapti pajni
mi'afra = cmila frati
plixauvla = pilno xamgu valsi
srilermorna = dasri lerfu morna
ticysku = tcica cusku
velcki = ve ciksi
fuzykamni = fuzme kamni
klacpe = klama cpedu
mivyske = jmive saske
mo'icli = morji cilre
pa'arbau = pacna bangu
stagycti = stagi citka
bavla'i = balvi lamji
degja'i = degji jadni
kulkla = ckule klama
noltroni'u = nobli jitro ninmu
nunpli = nu pilno
selfri = se lifri
fekcpi = fenki cipni
jefydiknalgundei = jeftu dikni na'e gunka djedi
kafxu'i = ckafi xukmi
lanpanzi = lanme panzi
nacpre = namcu prenu
nergau = nenri gasnu
sambau = skami bangu
sampre = skami prenu
selkelci = se kelci
selzva = se zvati
sumka'i = sumti krati
tolspofu = to'e spofu
birjai = birka jgari
jbojbe = lojbo jbena
jongau = jorne gasnu
nalceikri = na'e cevni krici
naldrani = na'e drani
seltivni = se tivni
smugau = smuni gasnu
tolcru = to'e curmi
zvafa'i = zvati facki
ctekra = nicte krasi
jbofanva = lojbo fanva
kansi'u = kansa simxu
nunjmaji = nu jmaji
samplabau = skami platu bangu
selklama = se klama
selpla = se platu
sipta'i = sipna tatpi
tarnau = tarci nanmu
toldrani = to'e drani
cibmasti = ci masti
ctigau = citka gasnu
gunstu = gunka stuzi
tolpo'u = to'e spofu
vlalinkei = valsi linsi kelci
xaskoi = xamsi korbi
cmicu'a = cmima cuxna
cuncuxna = cunso cuxna
je'urja'o = jetnu jarco
jupku'a = jukpa kumfa
nalselsau = na'e se slabu
sipsmacu = sipna smacu
smimlu = simsa simlu
terta'a = te tavla
vi'ecpe = vitke cpedu
barkla = bartu klama
blozeile'a = bloti zekri lebna
malpre = mabla prenu
naldra = na'e drani
nunpa'i = nu prami
tolnei = to'e nelci
vrogai = vorme gacri
zgigri = zgike girzu
ciftoldi = cifnu toldi
grusko = gurni skori
pipybanfi = plipe banfi
sutcli = sutra cilre
tcetcetce = mutce mutce mutce
zdadi'u = zdani dinju
cretadni = certu tadni
dicysro = dikca sorcu
mliba'u = milxe bacru
samseltcana = skami se tcana
samta'a = skami tavla
skepre = saske prenu
tergu'i = te gusni
tervensa = te vensa
brabra = barda barda
jbojevysofkemsuzgugje'ake'eborkemfaipaltrusi'oke'ekemgubyseltru = lojbo je softo ke su'o gugde jecta ke'e bo ke fatri prali turni sidbo ke'e ke gubni se turni
jbotadni = lojbo tadni
ki'ogra = kilto grake
lisxra = lisri pixra
samselmri = skami se mrilu
selci'i = se cinri
sfofybakni = sfofa bakni
skusku = cusku cusku
snaveica'a = sance vreji cabra
xajre'u = xarju rectu
xunblabi = xunre blabi
dalpe'o = danlu pendo
ka'amru = katna mruli
karsna = kalri sance
purlamji = purci lamji
sipfru = sipna frumu
tamsmi = tarmi simsa
tcesau = mutce slabu
tolclite = to'e clite
tolselzdi = to'e se zdile
vilti'a = vlile tcima
badgau = bandu gasnu
bavlamji = balvi lamji
cicyractu = cilce ractu
ckuzda = cukta zdani
cmacypre = cmaci prenu
glebre = gletu bredi
jbocertu = lojbo certu
jboske = lojbo saske
livyspoja = cliva spoja
malmla = mabla mlana
nazblu = nazbi ciblu
nonselsmu = no se smuni
samjudri = skami judri
sasfoi = srasu foldi
selpilno = se pilno
sezvei = sevzi vreji
zgica'a = zgike cabra
bavlamjeftu = balvi lamji jeftu
cibdei = ci djedi
clatei = clani temci
cukrerkavjvi = cukla renro kavbu jivna
datcme = drata cmene
drasku = drani cusku
kibykarni = kibro karni
kunkakpa = kunra kakpa
mitpavycinglepre = mintu pa cinse gletu prenu
nunpe'i = nu penmi
veljvo = ve lujvo
vlataidra = valsi tarmi drani
zbalermorna = zbasu lerfu morna
ba'urtadji = bacru tadji
filsmu = frili smuni
jbobadna = lojbo badna
kibycpa = kibro cpacu
malgle = mabla gletu
mutmi'i = mucti minji
retpei = preti pensi
selzdi = se zdile
toltce = to'e mutce
toltugni = to'e tugni
varkiclaflo'i = vacri kicne lafti bloti
ziftsa = zifre tsali
ci'omle = citno melbi
ckusro = cukta sorcu
gimvla = gismu valsi
jbosla = lojbo salci
joncku = jorne cukta
mitcinse = mintu cinse
nalbirti = na'e birti
prulamji = purci lamji
sampli = skami pilno
selfi'i = se finti
selpinxe = se pinxe
selsre = se srera
tankoi = tsani korbi
tolzdile = to'e zdile
zgisku = zgike cusku
bauske = bangu saske
fetpinji = fetsi pinji
ga'orgau = ganlo gasnu
najgenja = narju genja
pirfi'i = pixra finti
seldu'a = se dunda
slugu'a = sluji gunka
soldei = solri djedi
sorpa'i = so'i prami
tolzau = to'e zanru
xargismu = xanri gismu
xejykre = xedja kerfa
xelfanva = xe fanva
brabracrida = barda barda crida
firkre = flira kerfa
gleve'u = gletu vecnu
le'ipli = pleji pilno
lerbasysre = lerfu basti srera
maltcu = mabla nitcu
menfri = menli lifri
mlevla = melbi valsi
mo'ifli = morji fliba
naldji = na'e djica
terjvi = te jivna
tolsatci = to'e satci
tolsnuti = to'e snuti
trucau = turni claxu
truci'e = turni ciste
tumfakli'u = tumla facki litru
ba'urta'a = bacru tavla
blucri = ciblu cirko
blusfani = ciblu sfani
clamau = clani zmadu
crori'a = cortu rinka
gi'uste = gismu liste
ki'orgratretrefrinynidysnidu = kilto grake mitre mitre frinu snidu snidu
lausku = cladu cusku
nacybra = namcu barda
nilcla = ni clani
samnirna = skami nirna
seicni = sepli cinmo
selgu'a = se gunka
selvla = se valsi
selzgi = se zgike
selzvati = se zvati
toltu'i = to'e tugni
velski = ve skicu
xingu'e = xindo gugde
cabjeftu = cabna jeftu
cabvanci = cabna vanci
ckafybarja = ckafi barja
clatre = clani mitre
cnegau = cenba gasnu
dafsku = danfu cusku
glefi'a = gletu cfika
ki'otre = kilto mitre
lujyjvo = pluja lujvo
maljbo = mabla lojbo
mlebau = melbi bangu
multiple = mulno tiple
narselterdi = na se terdi
ninmlatu = cnino mlatu
pelnimre = pelxu nimre
rakcro = sraku cortu
sedycro = stedu cortu
selciska = se ciska
selkla = se klama
selpensi = se pensi
sitsku = sitna cusku
terklaku = te klaku
tolkargu = to'e kargu
tolnelci = to'e nelci
vanjba = vanju jbari
xrusnu = xruti casnu
bastygau = basti gasnu
cladakyxa'i = clani dakfu xarci
crogau = cortu gasnu
cusku'i = cusku kurji
dormidju = donri midju
faurtei = fasnu temci
glefra = gletu frati
je'erma'a = jetce cmana
mligla = milxe glare
nalci'o = na'e citno
nalre'ucti = na'e rectu citka
nintendo = cnino tendo
nurxru = snura xruti
rajycla = sraji clani
refcfa = krefu cfari
sursurla = surla surla
tolxamgu = to'e xamgu
vajrai = vajni traji
cendre = centi derxi
clajvo = clani lujvo
cnixai = cinmo xrani
falgau = farlu gasnu
filseljmi = frili se jimpe
jefnuzba = jeftu nuzba
malrarbau = mabla rarna bangu
matmau = mapti zmadu
merja'a = merko jatna
mi'ipre = minji prenu
nuntavla = nu tavla
primi'i = prina minji
selcfipu = se cfipu
seldjuno = se djuno
seljbobau = se lojbo bangu
sibvidru = sidbo vidru
sudgau = sudga gasnu
ta'irva'u = tatpi vasxu
tedyskepre = terdi saske prenu
tergusni = te gusni
terjbe = te jbena
terzu'e = te zukte
tolracli = to'e racli
tolsti = to'e sisti
xrisma = maxri smaji
zanbebna = zabna bebna
zengau = zenba gasnu
ziltau = zi'o tanru
bavgaupei = balvi gasnu pensi
ciplanli = cipra lanli
cizbau = cizra bangu
denmikce = denci mikce
favytcini = farvi tcini
filta'a = frili tavla
jajgau = jmaji gasnu
jbesla = jbena salci
jbocli = lojbo cilre
jbocradi = lojbo cradi
jbotavla = lojbo tavla
jintyke'a = jinto kevna
jvozba = lujvo zbasu
kibystu = kibro stuzi
klunu'i = kulnu nutli
nalsa'uslakyskute'a = na'e sarcu slaka cusku terpa
nalzva = na'e zvati
ralcku = ralju cukta
rolgimcre = ro gismu certu
selbapselfu = se bapli selfu
selcmene = se cmene
selgei = se gleki
spofygau = spofu gasnu
sumpoi = sumti porsi
terxra = te pixra
velmikce = ve mikce
vlabacru = valsi bacru
xavyselmla = xa se mlana
xlafri = xlali lifri
banbau = bangu bangu
bantadni = bangu tadni
bavlamna'a = balvi lamji nanca
bropre = xebro prenu
cnijicla = cinmo jicla
falcru = farlu curmi
jboclidju = lojbo cilre sidju
krafamtei = krasi fanmo temci
lardai = larcu dacti
mencrekei = menli certu kelci
molgle = moklu gletu
mulna'u = mulno namcu
nalju'o = na'e djuno
plicu'a = pilno cuxna
rafcre = rafsi certu
ratske = ratni saske
relmomlojni'i = re moi logji nibli
rodbo'e = broda brode
rolju'o = ro djuno
sa'irbi'o = sanli binxo
terskina = te skina
tolfadni = to'e fadni
toljinga = to'e jinga
tormau = tordu zmadu
verclibau = verba cilre bangu
vilfredo = vlile fredo
vitci'i = vitci cinri
zgatirna = zgana tirna
banske = bangu saske
frabau = frati bangu
glecki = gletu ciksi
gluglu = gluta gluta
jbonei = lojbo nelci
jimpre = jinme prenu
lekmi'i = lenku minji
lidvru = lindi savru
mibypre = mi prenu
mi'ecpe = minde cpedu
mivmu'e = jmive munje
mlerai = melbi traji
mutpapri = mucti papri
nunsku = nu cusku
plika'e = pilno kakne
rafske = rafsi saske
rolrafcre = ro rafsi certu
samxa'a = skami xatra
sapselga'e = sampu se ganse
selfanva = se fanva
seljibri = se jibri
selju'o = se djuno
selsenva = se senva
selsmuni = se smuni
sezga'o = sevzi ganlo
sidysmu = stidi smuni
sipku'a = sipna kumfa
sorpa'a = so'i pacna
srebandu = srera bandu
sutyta'asre = sutra tavla srera
tcexau = mutce xamgu
tersei = te sepli
toldji = to'e djica
tolgendra = to'e gerna drani
tolgleki = to'e gleki
tolpluka = to'e pluka
tolvajni = to'e vajni
vonplini = vo plini
xalpinxe = xalka pinxe
xaufri = xamgu lifri
zbaske = zbasu saske
balbaltadni = banli banli tadni
cermurse = cerni murse
cleverdra = <cle> verba drani
cmananba = cmalu nanba
firgai = flira gacri
flizu'e = fliba zukte
ga'arboiterjvi = grana bolci te jivna
gledji = gletu djica
glijbo = glico lojbo
glita'a = glico tavla
jboste = lojbo liste
jdazei = lijda zekri
kafpinxe = ckafi pinxe
kalcyvi'i = kalci vikmi
kesmarce = kensa marce
la'orbau = latmo bangu
laktergu'i = lakse te gusni
larlermorna = larcu lerfu morna
lumku'a = lumci kumfa
mafcribe = makfa cribe
mipyzga = mipri zgana
naknakcinse = nakni nakni cinse
nungle = nu gletu
nunsipna = nu sipna
pensi'u = penmi simxu
raftunba = rafsi tunba
selfi'u = se cfipu
seljmina = se jmina
selylijda = se lijda
skezu'e = saske zukte
snustu = casnu stuzi
tolgei = to'e gleki
tolslabu = to'e slabu
tolxagji = to'e xagji
tu'urbirka = tubnu birka
velcu'e = ve ckule
xadykelci'e = xadni kelci ciste
xagzengau = xamgu zenba gasnu
zgica'apli = zgike cabra pilno
baljbo = banli lojbo
bantoi = bangu troci
bavlamcerni = balvi lamji cerni
bavlamcte = balvi lamji nicte
brebi'o = bredi binxo
cabycedra = cabna cedra
ci'erselkei = ciste se kelci
comdei = co'e djedi
fasybau = fraso bangu
fi'urgau = cfipu gasnu
fu'esku = fuzme cusku
glagi'u = glare gismu
jbosne = lojbo senva
jbovalsi = lojbo valsi
jesymabru = jesni mabru
klagau = klama gasnu
kulcitsi = ckule citsi
lauble = cladu ruble
mlinintadni = milxe cnino tadni
nakspe = nakni speni
nalselcme = na'e se cmene
nelti'i = nelci stidi
nunmro = nu morsi
plajva = platu javni
rapsku = rapli cusku
rectangle = rectu tsani gletu
remsmimi'i = remna simsa minji
sazycimde = sazri cimde
selmipri = se mipri
selneimau = se nelci zmadu
selplijibri = se pilno jibri
selzu'e = se zukte
snusma = casnu smaji
terbe'i = te benji
terpemci = te pemci
tolcicygau = to'e cilce gasnu
tolprali = to'e prali
veltivni = ve tivni
xalfenki = xalka fenki
dzejbo = dzena lojbo
fetpa'i = fetsi prami
jbolatmi'a = lojbo mlatu cmila
jbopendo = lojbo pendo
jbosisri'i = lojbo sisku ritli
jetmlu = jetnu simlu
juknynanba = jukni nanba
kemke'e = ke ke'e
kibjorne = kibro jorne
kulgu'a = ckule gunka
kulzva = ckule zvati
mafpre = makfa prenu
mlemau = melbi zmadu
mo'isti = morji sisti
mujysamseltcana = munje skami se tcana
nakcinse = nakni cinse
nalbanzu = na'e banzu
neitce = nelci mutce
nilnalci'o = ni na'e citno
nunfanva = nu fanva
nunpai = nu pajni
nunsalci = nu salci
pairkamni = pajni kamni
pairkamnycmi = pajni kamni cmima
pairnu'i = pajni nutli
relcu'e = re ckule
samvidni = skami vidni
selcasnu = se casnu
selmanci = se manci
selneizma = se nelci zmadu
selstidi = se stidi
terbi'a = te bilma
tolcnino = to'e cnino
tolsurla = to'e surla
tolvai = to'e vajni
tupyjanco = tuple janco
xisnunjbe = xriso nu jbena
zgagau = zgana gasnu
balrai = banli traji
baltadni = banli tadni
bifpra = brife cupra
cabnicte = cabna nicte
cadgu'a = cando gunka
cakcinki = calku cinki
cinjikca = cinse jikca
cnicni = cinmo cinmo
cnise'i = cinmo sevzi
crezu'e = certu zukte
dabytadji = damba tadji
fonjudri = fonxa judri
gaurtcini = gasnu tcini
glepe'o = gletu pendo
gunrivzu'e = gunka rivbi zukte
jvopa'i = lujvo prami
keidji = kelci djica
le'otci = lenjo tutci
ma'ekla = marce klama
mliju'i = milxe jundi
naljvajvo = na'e javni lujvo
nalspofu = na'e spofu
narzva = na zvati
ninjbopre = cnino lojbo prenu
nonseldi'a = no se jdima
nuncipra = nu cipra
nunde'a = nu denpa
nunjo'e = nu jorne
pamsi'u = prami simxu
pinjycarvi = pinji carvi
purdykurji = purdi kurji
radji'i = randa jinvi
sajbi'o = sanji binxo
samxanri = skami xanri
selka'e = se kakne
selte'i = se steci
selzgike = se zgike
siptcu = sipna nitcu
skefi'a = saske cfika
sligau = slilu gasnu
spofybakni = spofu bakni
tamxri = tarmi maxri
terpli = te pilno
tervecnu = te vecnu
titspi = titla spisa
tolcu'i = to'e cumki
toljimpe = to'e jimpe
tolvrude = to'e vrude
tsazenzu'e = tsali zenba zukte
tsutre = rotsu mitre
velcusku = ve cusku
veltcika = ve tcika
xarskami = xanri skami
zaisle = zarci selci
zanfunca = zabna funca
zgifi'i = zgike finti
zgitirna = zgike tirna
zilcmi = zi'o cmima
zirjbo = zirpu lojbo
brabaktu = barda baktu
bramau = barda zmadu
cabycerni = cabna cerni
carbi'e = carna brife
cmaxirma = cmalu xirma
cnoconcoi = condi condi condi
ctemidju = nicte midju
ctitci = citka tutci
ctucku = ctuca cukta
cukmakyvelvei = cukla maksi ve vreji
dijbartu = dinju bartu
filmau = frili zmadu
fladra = flalu drani
gimfi'i = gismu finti
gimtai = gismu tarmi
jbogri = lojbo girzu
jbopulji = lojbo pulji
jupypesxu = jukpa pesxu
kacmyxra = kacma pixra
kibdu'a = kibro dunda
malbebna = mabla bebna
mamgle = mamta gletu
melbau = melbi bangu
najyzme = narju guzme
naljimpe = na'e jimpe
nalselrinsa = na'e se rinsa
nornei = no'e nelci
nuncti = nu citka
nunmliba'u = nu milxe bacru
pirpoi = pixra porsi
plifonxa = pilno fonxa
ralcinfra = ralju cinse frati
ratmidju = ratni midju
rolcmaxi'a = ro cmalu xirma
ruxse'i = pruxi sevzi
samstuzi = skami stuzi
selcitka = se citka
selsmi = se simsa
sinytci = tsina tutci
spebi'o = speni binxo
tcenelci = mutce nelci
terfrica = te frica
tivyskina = tivni skina
tolcilce = to'e cilce
tolcurmi = to'e curmi
toldu'e = to'e dukse
toljinsa = to'e jinsa
xaupli = xamgu pilno
za'idji = zasti djica
zanfu'a = zabna funca
zanvi'e = zabna vitke
zilxruti = zi'o xruti
balnobli = banli nobli
batmai = batci marji
blabla = blanu blanu
bripre = bridi prenu
cakcurnu = calku curnu
capli'u = ckape litru
cfipygau = cfipu gasnu
cibjgatai = ci jganu tarmi
cidrjypitsa = cidni
cinma'o = cinse cmavo
ckopalku = cokcu palku
cmavla = cmalu valsi
cmizu'e = cmima zukte
damtu'u = danmo tubnu
degja'o = degji jarco
drapli = drani pilno
fukfinpe = fukpi finpe
ga'avro = grana vorme
jbedetri = jbena detri
jbobacru = lojbo bacru
jbofongri = lojbo fonxa girzu
jbogli = lojbo glico
jboselbau = lojbo se bangu
jedji'o = jendu jipno
jifsku = jitfa cusku
ji'isku = jinvi cusku
jimdei = jinme djedi
jvocme = lujvo cmene
kamsutra = ka sutra
kindi'u = skina dinju
kulgunka = ckule gunka
laxma'i = lanxe masti
livrinsa = cliva rinsa
lojycpa = logji cpacu
lutnilcla = pluta ni clani
ma'ovla = cmavo valsi
malgi'u = mabla gismu
maljvo = mabla lujvo
malsku = mabla cusku
mamymamta = mamta mamta
mlimli = milxe milxe
nalcrino = na'e crino
nalsmudra = na'e smuni drani
namkei = nabmi kelci
nilsutra = ni sutra
pamsla = prami salci
pinjystedu = pinji stedu
plixaumau = pilno xamgu zmadu
pongu'e = ponjo gugde
prijyske = prije saske
pukfri = pluka lifri
purla'i = purci lamji
raltca = ralju tcadu
ricko'i = tricu kobli
selbitmu = se bitmu
selcku = se cukta
seldjica = se djica
selgunka = se gunka
selpi'o = se pipno
selsni = se sinxa
selspaji = se spaji
selte'a = se terpa
selvi'a = se viska
sezyjgidu'e = sevzi jgira dukse
skuspu = cusku spuda
sluzenzu'e = sluji zenba zukte
sresku = srera cusku
stifle = sisti flecu
tcacpi = tcadu cipni
tcebra = mutce barda
tercmene = te cmene
terporcmi = te porsi cmima
tertavla = te tavla
tolcfa = to'e cfari
toldukse = to'e dukse
tolmutce = to'e mutce
tolse'a = to'e setca
tsebi'o = zutse binxo
velcku = ve cukta
vlabasxajmi = valsi basti xajmi
voksna = voksa sance
xasyjukni = xamsi jukni
zilzilzilmabla = zi'o zi'o zi'o mabla
zukpei = zukte pensi
balckule = banli ckule
bemboiterjvi = bemro bolci te jivna
bicydja = bifce cidja
bogykamju = bongu kamju
bramabru = barda mabru
cavysezlu'i = carvi sevzi lumci
cimvla = cilmo valsi
ciprolmoi = cipra ro moi
cmaskami = cmalu skami
cmecau = cmene claxu
cnipre = cinmo prenu
concnocoi = condi condi condi
cpanygle = cpana gletu
darvistci = darno viska tutci
degygutci = degji gutci
detke'u = detri krefu
djugei = sidju gleki
durmijnunsla = dunra midju nu salci
dzukla = cadzu klama
fekpre = fenki prenu
filterjmi = frili te jimpe
gentilsnu = gerna tcila casnu
glajukpa = glare jukpa
gugja'a = gugde jatna
jamji'a = jamna jinga
jbokei = lojbo kelci
jboselsku = lojbo se cusku
jboskepre = lojbo saske prenu
jintitnanba = djine titla nanba
kapxra = skapi pixra
kelgi'a = kelci gidva
kelka'u = kelci kantu
ki'asku = krixa cusku
kuktce = kukte mutce
lampru = lamji purci
latpukcmo = mlatu pluka cmoni
lerpinsle = lerfu pinta selci
lerpoi = lerfu porsi
livbai = cliva bapli
maldotco = mabla dotco
malkalci = mabla kalci
melmau = melbi zmadu
melsku = melbi cusku
mutcei = mucti cevni
nabzba = nanba zbasu
nalcafne = na'e cafne
nalcumki = na'e cumki
nalfadni = na'e fadni
ni'ablo = cnita bloti
pavysmu = pa smuni
pijyskepre = prije saske prenu
posydji = ponse djica
posyselfai = ponse se fatri
prulamjeftu = purci lamji jeftu
samse'a = skami setca
samselpli = skami se pilno
se'iski = sevzi skicu
selcmipi'i = se cmima pilji
selcru = se curmi
selcu'a = se cuxna
selmacygu'e = se manci gugde
selpei = se pensi
selta'a = se tavla
sensei = senpi sepli
smacni = smaji cinmo
smusku = smuni cusku
staple = stali pelji
suzyterki'i = su'o te ckini
tacpe'u = tance pencu
tamgrupesxu = tarmi gurni pesxu
tcecmada'u = mutce cmalu danlu
tcegei = mutce gleki
terjonma'o = te jorne cmavo
tersku = te cusku
toljunri = to'e junri
tolspaji = to'e spaji
tsiselcigla = tsiju se cigla
vimstizu = vikmi stizu
volratcu = vofli ratcu
xairgau = xrani gasnu
xlagerna = xlali gerna
xumbebna = xukmi bebna
zausku = zanru cusku
zerpre = zekri prenu
zgivei = zgike vreji
zilfanva = zi'o fanva
bardzukla = bartu cadzu klama
bemjoitco = bemro joi ketco
bigboi = bilga bolci
cabna'a = cabna nanca
caucme = claxu cmene
celxa'i = cecla xarci
cersaigru = cerni sanmi gurni
cizyprije = cizra prije
clugau = culno gasnu
creze'a = certu zenba
cu'upre = cuntu prenu
derse'a = dertu setca
djaruntyrango = cidja runta rango
dramau = drani zmadu
dunsi'u = dunli simxu
faglo'u = fagri lorxu
glagau = glare gasnu
glipre = glico prenu

